################################################################
S                                                              #
#                                                              #
#                                                              #
#                                                              #
#                                                              #
#                                                              #
#                                                              #
# ##############################################################
#                                                              #
#                                                              #
#                                                              #
#                                                              #
#                                                              #
#                                                              #
#                                                              #
#                                                              #
#                                                              #
#                                                              #
#                                                              #
#                                                              #
#                                                              #
############################################################## #
#                                                              #
#                                                              #
#                                                              #
#                                                              #
#                                                              #
#                                                              #
#                                                              #
# ##############################################################
#               #                        #                     #
#               #                                              #
#               #                        #                     #
#               #                        #                     #
#               #                        #                     #
#               #                        #                     #
#               #                        #                     #
#               #                        #                     #
#               #                        #                     #
#               #                        #                     #
#               #                        #                     #
#               #                        #                     #
#               #                        #                     #
#               #                        #                     #
#               #                        #                     #
#               #                        #                     #
#               #                        #                     #
#               #                        #                     #
#               #                        #                     #
#               #                        #                     #
#               #                        #                     #
#               #                        #                     #
#               #                        #                     #
#               #                        #                     #
#               #                        #                     #
#               #                        #                     #
#               #                        #                     #
#               #                        #                     #
#               #                        #                     #
#               #                        #                     #
#                                        #                     #
#               #                        #                     G
################################################################
